一::one
人::people
里::inside
会::Can
没::No
她::she
吗::question particle for "yes-no" questions
去::go
也::and also
有::Have
这::this
那::That
不::Do not
什::Varied
个::indivual
来::Come
要::want
就::At once
我::I
你::you
的::of
是::Yes
了::completed action marker
他::he
么::exclamatory final particle
们::plural marker for pronouns, and nouns referring to individuals
在::exist
说::Say
为::for
好::good
吧::Bar
知道::knowledge
我的::mine
和::with
你的::yours
想::think
只::only
很::very
都::All
对::right
把::Bundle
啊::what
怎::How
得::have to
还::return
过::pass
不是::no
到::arrive
样::Sample
飞::fly
远::Far
身::body
任何::any
生活::Life
够::enough
号::No
兰::Orchid
瑞::Rui
达::Reach
或::or
愿::willing
蒂::Pedicle
別::do not
军::military
正::just
是不是::is not it
证::certificate
不用::Need not
三::three
乐::happy
吉::lucky
男人::man
告訴::Tell
路::road
搞::Engage in
可是::But
与::and
次::Second-rate
狗::dog
决::Decide
金::gold
史::history
姆::Hm
部::Department
正在::Being
活::live
刚::Just
回家::go home
贝::cowry
如何::how
须::Must
战::war
不會::will not
夫::husband
喂::Hey
父::father
亚::Asia
肯定::affim
女孩::girl
世界::world
不要::do not want
些::some
不知道::do not know
不能::can not
因::because
觉::Sleep
发::send
像::picture
太::too
但是::but
多::many
打::beat
机::machine
來::Come
好了::All right
用::use
他的::his
诉::Complain
德::Ethics
叫::Call
什麼::what
真::real
干::Dry
心::Heart
走::go
比::Compare
死::die
嘿::Hey
出::out
车::vehicle
一下::one time
中::middle
好吧::All right
需要::need
经::through
妈::mom
候::Waiting
长::long
而::and
错::mistaken
好的::OK
间::between
又::again
国::country
起::rise
动::move
杀::kill
于::At
种::kind
去了::went
担::Burden
名::name
混蛋::asshole
礼::present
幹::Dry
不了::No more
有些::some
過::pass
後::Rear
击::hit
漂亮::Pretty
神::God
多少::How many
海::Ocean
每::Every
哥::elder brother
教::teach
走吧::Let's go
好像::like
单::one
公::male
林::Forest
女::Female
忙::busy
火::fire
钟::Bell
家伙::Guys
科::division
回去::go back
最后::finally
水::water
不管::Regardless of
麦::wheat
泻::diarrhea
鬼::ghost
還::return
船::ferry
永::forever
安全::Safety
那個::that
爾::you
這麼::so
满::Full
风::wind
皮::Skin
威::Prestige
据::according to
鲁::Lu
转::change
相::Mutually
地方::place
沒有::No
有人::Someone
嗨::Hi
看看::have a look
自己::Own
一定::must
事情::matter
屑::Crumbs
希望::hope
所::Place
褉::Blessed
感::feel
气::gas
不想::In no mood
嘛::Well
实::Reality
始::beginning
給::Give
然后::Then
個::indivual
相信::Believe
结::Knot
今天::Nowadays
几::Several
题::question
放::put
讓::let
确::Indeed
意思::mean
成::become
所有::all
喜::happiness
對::right
之::Of
一切::everything
记::remember
抱歉::Feel sorry
一直::Always
天::sky
褌::drawers
钱::money
面::noodle
更::Even
学::study
現在::now
边::side
你們::you
不起::Can't afford
脑::brain
呃::Uh
论::s
曼::Man
點::point
普::general
第一::First
通::Pass
棒::Great
线::String
很高::Very high
买::purchase
求::begging
束::bundle
哇::Wow
指::refer to
张::open
文::Arts
锌::Zinc
重::Heavy
菲::Fei
目::Item
根本::fundamental
联::United
丹::Dan
愛::Love
不到::Less than
這些::These
自己的::my own
笑::laugh
闭::close
基::base
唯一::only
要是::if
提::carry
调::Tune
丽::Korea
女士::Miss
校::school
公司::company
况::condition
烦::bother
停::stop
英::Britain
警::police
险::risk
東西::thing
不可能::impossible
坐::sit
区::Area
果::fruit
伙::Partner
哈::what
罗::Luo
难::difficult
两::two
一些::Some
這樣::so
自::since
女人::woman
向::Towards
最好::most
走了::gone
褬::Coat
胁::Threaten
明::bright
理::reason
加::add
枪::gun
万::ten thousand
员::member
妳::You
玩::Play
分::Minute
作::do
巴::-bar
而且::and
物::Thing
伤::hurt
官::official
道::road
出去::go out
力::force
总::total
者::By
先::First
最::most
很多::a lot of
医::medical
一次::once
报::Report
名字::name
将::will
迪::Di
到了::arrive
解::untie
新::new
队::team
识::knowledge
死了::died
眼::Eye
媽的::Oh shit
第一次::the first time
離開::Leave
忘::forget
我自己::Myself
谐::Harmony
严::strict
且::and
帶::belt
赶::Rush
太棒::Great
佛::Buddha
直::straight
認為::think
老婆::Wife
索::So
除了::Apart from
承::Inherit
泰::Thai
建::establish
欧::Europe
然後::Then
级::class
昨晚::last night
石::stone
有了::With
都有::Both have
磲::磲
差::Difference
思::think
啥::What
過來::come over
努力::effort
丈夫::husband
任何人::anyone
城市::city
死亡::die
全部::all
组::Group
i::i
也許::maybe
最近::recent
倒::fall
领::collar
顾::Gu
市::city
六::six
行了::okay
滚::roll
好嗎::Alright
师::division
高::high
莉::Li
坏::Bad
电::Electricity
警察::police
件::Pieces
誰::Who
兄弟::brother
之前::Before
谈::talk
送::deliver
森::Sen
伊::Yi
以前::before
房::House
婚::marriage
喝::drink
怎麼::how
今晚::tonight
兴::prosper
疯::Crazy
因為::Because
住::live
内::Inside
轻::light
约::make an appointment
声::Voice
或者::or
不行::no
到底::in the end
雷::Thunder
维::dimension
条::strip
明天::tomorrow
不好::not good
已經::already
天啊::Oh my god
洛::Luo
护::Protect
塔::tower
运::transport
接::catch
球::ball
得到::get
穿::Put on
音::sound
從::From
為::for
生::pregnancy
回::Back to
可::Can
东::East
尔::you
欢::joyous
很好::very good
他們::them
进::Enter
地::land
孩子::child
帮::help
离::Leave
找::Find
尼::Ni
从::From
下::Down
马::Horse
以::by
利::profit
所以::so
关::shut
哪::where
懈::negligent
行::Row
家::Family
拉::pull
才::talent
看到::See
說::Say
手::hand
法::Law
噢::Oh
谁::Who
头::head
无::without
嗯::Um
工作::Work
可能::possible
薪::salary
朋友::friend
请::Please
许::May
年::year
那些::Those ones
一個::one
一起::Together
然::correct / right / so / thus / like this
吃::eat
写::Write
带::belt
我喜::I like
弗::Fu
尽::Exhausted
耶::Yeah
喔::Oh
褍::Yin
掉::Lose
书::Book
其他::other
派::group
士::scholar
器::Device
松::loose
数::number
光::Light
其::That
想我::miss me
极::pole
合::combine
完全::completely
做了::Done
影::film
室::room
受::by
奇::strange
试::try
装::Pack
晚上::night
恶::evil
应::answer
小姐::Miss
整::all
强::powerful
业::industry
类::kind
复::complex
奥::Oh
梦::Dream
曾::Once
嘴::Mouth
认::recognize
如此::in this way
爸::dad
照::According to
杰::Jie
為什麼::why
入::enter
睡::sleep
都不::Neither
服::Clothes
节::Festival
顿::pause
了解::learn
根::root
蛋::Egg
紧::tight
麻::numb
很快::soon
游::tour
忘了::forget
戴::wore
莎::Sha
故事::story
视::See
真正::real
蟹::crab
费::fee
靠::Depend on
全::Complete
反::opposite
字::Character
度::Spend
甚至::even
局::Bureau
莫::Mo
命::Life
语::language
性::sex
常::often
莱::Lai
之后::Later
可不::May not
母::mother
留下::Leave
外::outside
當::when
此::this
惊::shock
伯::Uncle
口::mouth
喜歡::like
在做::doing
那麼::So
請::Please
五::five
标::Mark
画::painting
身上::Body
以后::after
主::host
謝謝::thanks
應該::should
静::quiet
弹::bomb
改::change
酒::liquor
伦::Lun
裏::inside
花::flower
续::Continued
天哪::Oh my goodness
這裡::here
房子::House
何::what
由::Depend on
药::medicine
同::same
早上::Morning
波::Wave
弄::alley
务::Work
原::Original
失::lose
考::Test
岁::age
统::Unify
斜::incline
拜托::Please
跑::run
不在::Not in
害::Harmful
麽::tiny / insignificant
日::day
妮::Ni
凯::Kai
衣服::clothing
治::rule
便::Poop
客::guest
议::Discuss
好好::well
們::men 们
覺得::feel
谢谢::thanks
托::Entrust
赛::Match
任::appoint
色::color
独::alone
眼睛::Eye
黑::black
华::magnificent
放在::Put on
城::city
的時候::when
站::stand
小孩::Child
住在::live
咖啡::coffee
换::Change
才是::Is
褕::Glutinous
周::week
控制::control
言::Word
敢::dare
赢::win
半::Half
白::White
释::release
能不能::Can you
生了::gave birth
而已::That's it
图::picture
該::Should
怪::Strange
字幕::subtitle
對不起::sorry
去看::Go see
像是::Like
保持::Keep
替::for
拜::bye
一件::One piece
錢::money
想知道::Want to know
時::Time
讲::speak
新的::new
希::hope
炸::fry
择::select
知::Know
說的::Said
码::code
戏::play
塞::Stuffed
碰::bump
放下::lay down
一樣::Same
害怕::Fear
杰克::Jack
迎::welcome
绝::Absolutely
開始::Start
生命::life
王::King
助::help
乔::Joe
义::righteous
回到::Back to
救::save
清楚::clear
冷::cold
原因::reason
却::but
付::pay
管::Tube
狂::mad
早::morning
一天::one day
超::overtake
怀::Conceive
使::Make
断::Cut off
演::play
外面::Outside
四::Four
楼::building
另一::another
玩笑::joke
好啊::OK
裡::inside
院::hospital
空::null
娜::Na
將::will
下去::Go down
传::pass
時間::time
感到::feel
懂::Understand
血::Blood
失去::lose
终::end
還是::still
价::price
包::Bag
等::Wait
变::Change
准::allow
查::check
阿::an initial particle / prefix to names of people
卡::Card
這個::this
在哪::where
定::Certainly
处::Place
真是::Really
保::Save
想要::want to
安::install
并::and
拿::take
情::Affection
爸爸::dad
褋::Shaggy
您::you
美::beautiful
非常::Very
办::manage
前::forward
格::grid
场::field
体::body
大家::Everyone
呀::Ah
系::Tie
后::Rear
亲::Dear
明白::clear
备::Prepare
布::cloth
计::count
恩::Yep
找到::turn up
她的::her
老::old
艾::Ai
意::meaning
门::door
啦::La
米::Meter
本::Book
问::Ask
上帝::God
必::must
沒::No
等等::and many more
不過::but
猜::guess
福::blessing
打算::Intend
适::suitable
危::In danger
连::even
怕::afraid
化::change
不需要::unnecessary
争::Contend
则::but
狱::prison
越::cross
小子::Kid
有趣::interesting
至少::At least
亞::Asia
脱::Take off
消息::information
不喜::do not like
块::Piece
快走::Go fast
著名::famous / celebrated
各位::Everybody
算::Calculate
問題::problem
沒事::fine
导::guide
州::State
老兄::Dude
抓::Grasp
代::generation
蒙::Mongolian
抓住::catch
山::Mountain
拍::shoot
沙::sand
妻子::wife
脸::Face
责::responsibility
你自己::yourself
回來::return
歌::Song
星::star
权::right
术::Technique
显::Show
幸::fortunate
交::pay
不同::different
聪::Satoshi
随::Follow
登::Board
班::class
二::two
录::record
武器::arms
热::hot
才能::Ability
當然::certainly
晚::Night
晚安::Good night
成功::success
未::not yet
参::Participate
瓦::watt
饭::Rice
殺::kill
帕::Pa
待::treat
是否::whether
勒::Le
射::shoot
表::surface
卫::guard
太太::Mrs
接受::accept
跳::Jump
象::elephant
灵::spirit
真不::really not
破::break
夫人::lady
操::Hold
诺::promise
萨::Sa
卖::Sell
选::select
注意::Notice
历::calendar
脚::foot
丝::Silk
少::few
工::work
密::dense
鱼::fish
验::Test
不再::no longer
检::Check
骗::cheat
必須::must
a::a
自由::free
杯::Cup
馆::Pavilion
完::over
追::Chase
际::Inter
产::Produce
想到::think
收::receive
探::Explore
直到::until
酷::cool
乱::chaos
资::Capital
毁::destroy
要求::Require
急::urgent
玛::Ma
方::square
完成::Finish
照片::Photo
收到::receive
所有人::All
博士::PhD
媽媽::mother
you::you
父母::parents
奇怪::strangeness
男孩::boy
攻::attack
店::shop
埃::Angstrom
多久::how long
红::Red
太多::too much
咱::we
能::can
事::thing
看::Look
我們::US
上::superior
给::Give
可以::Can
现::now
斯::S
做::Do
儿::Son
时::Time
点::point
开::open
让::let
就是::that is
但::but
呢::Woolen cloth
着::aspect particle indicating action in progress
它::it
這::this
如果::if
跟::and
邪::evil
听::hear
克::gram
再::Again
快::quick
嗎::question particle for "yes-no" questions
被::quilt
是的::Yes
大::Big
先生::gentlemen
别::do not
告::tell
真的::real
谢::Thanks
哦::Oh
话::talk
械::Machinery
见::See
当::when
芯::core
该::Should
西::West
子::son
已::already
會::Can
小::small
爱::Love
特::special
