כמו::same as
אני::i am
שלו::his
ש...::that
הוא::he
היה::was
עבור::for
על::on
הם::they (masculine)
עם::with
להיות::to be
ב...::at
אחד::one
יש לי::i have
זה::it
מ...::from
על ידי::by
חם::hot
מילה::word / circumcision
אבל::but
מה::what
כמה::some
אתה::you (male)
או::or
היה לי::i had (masculine thing)
של::of
אל::to
ו...::and
זמן::time
אנחנו::we
יכול::can (masculine)
את::you (feminine)
אחר::other (masculine)
היו::there were
לעשות::to do
שלהם::their
אם::if
יהיה::will be
איך::how
אמר::said
בית::home
כל::all
לספר::tell
עושה::is doing
שלוש::three
רוצה::wants to
אוויר::air
גם::also
לשחק::to play
קטן::little
סוף::end
לשים::to put
לקרוא::to read
יד::hand
נמל::port
גדול::big
לאיית::to spell
להוסיף::add
אפילו::even
ארץ::country
כאן::here
חייב::have to
גבוה::tall
כזה::such a
מעקב::tracking
מעשה::act
מדוע::why
שואל::asks
אנשים::people
לשנות::to change
הלכתי::i walked
אור::light
סוג::type
צריך::should
תמונה::image
לנסות::try
שלנו::our
שוב::again
חיה::an animal
נקודה::point
אמא::mother
עולם::world
ליד::next to
לבנות::to build
עצמי::myself
כדור הארץ::earth
אב::father
חדש::new
עבודה::working
חלק::part
לקחת::to take
לקבל::get
מקום::place
עשיתי::i did
לחיות::live
איפה::where
לאחר::after the
בחזרה::back to
רק::only
עגול::round
גבר::man
שנה::sleep
הגיע::has come
מופע::show
טוב::are good
לי::to me
לתת::give
תחת::under
שם::name
מאוד::is very
דרך::way
טופס::form
משפט::sentence
חושב::thinking
אומר::says
לעזור::help
נמוך::low
שורה::row
שונה::different
תור::turn
סיבה::reason
הרבה::much
לפני::before
מהלך::walk
נכון::right
ילד::boy
ישן::old
אותו::him
היא::she
כאשר::when are
למעלה::up
שימוש::use
שלך::your
רבים::many
אז::then
לכתוב::to write
היית::you were
כך::so
אלה::goddess
שלה::its
ארוך::long
דבר::nothing
לראות::see
שנים::years
יש::there is
להסתכל::to look
יותר::more
יום::a day
ללכת::go
תבואו::come
מספר::a number
נשמע::audible
לא::no
ביותר::most
שלי::my
יודע::know
מים::water
מאשר::than
שיחה::call
ראשון::first
מי::who will
רשאי::entitled
למטה::down
צד::trapping
עכשיו::now
למצוא::find
ראש::head
לעמוד::to stand
דף::page
מדינה::country
מצאתי::found
תשובה::answer
בית ספר::school
לגדול::grow
מחקר::research
עוד::more
ללמוד::learn
צמח::plant
כיסוי::coverage
מזון::food
שמש::sun
ארבעה::four
בין::between
לשמור::preserve
עין::eye
אף פעם לא::never
אחרון::latest
בואו::come
חשבתי::i thought
עיר::city
עץ::wood
לחצות::to cross
החווה::the farm
קשה::hard
התחלה::start
אולי::maybe
סיפור::a story
מסור::saw
רחוק::far away
ים::sea
לצייר::to draw
עזב::left
מאוחר::late
לרוץ::run
תוך::within
עיתונות::journalism
קרוב::close
לילה::night
אמיתי::true
חיים::haim
צפון::north
ספר::book
לשאת::bear
לקחתי::i took
מדע::science
לסעוד::dine
חדר::a room
חבר::member
החל::starting
רעיון::idea
דגים::fish
הר::mountain
להפסיק::stop
פעם אחת::once
בסיס::base
לשמוע::listen
סוס::horse
לחתוך::cut
בטוח::sure
לצפות::watch
צבע::color
פנים::face
עיקרי::main
פתוח::open
נראה::seen
יחד::together
הבא::the next
לבן::white
ילדים::children
להתחיל::begin
דוגמא::example
להקל::facilitate
נייר::paper
קבוצה::group
תמיד::always
מוסיקה::music
שני::crimson
סימן::sign
לעתים קרובות::often
מכתב::letter
עד::until
מייל::miles
נהר::river
מכונית::car
רגליים::feet
טיפול::treatment
מספיק::enough
מישור::plain
ילדה::girl
כרגיל::as usual
צעיר::young
מוכן::prepared
מעל::above
אי פעם::ever
אדום::red
רשימה::list
למרות ש::although
להרגיש::to feel
דיבורים::talk
ציפור::a bird
בקרוב::soon
גוף::body
כלב::dog
משפחה::family
ישיר::direct
פוזה::pose
לעזוב::leave
שיר::a poem
למדוד::measure
דלת::door
מוצר::product
שחור::black
קצר::short
ספרה::number
כיתה::grade
רוח::breeze
שאלה::a question
לקרות::to happen
מלא::full
ספינה::ship
אזור::area
מחצית::half
רוק::rock
כדי::in order to
אש::fire
דרום::south
בעיה::problem
חתיכה::piece
אמר לי::told me
ידעתי::i have known
עובר::passes
מאז::since
עליון::upper
מלך::king
רחוב::street
אינץ::inches
להכפיל::double
שום דבר::nothing
כמובן::of course
להישאר::to stay
גלגל::pulley
כוח::force
כחול::blue
אובייקט::object
להחליט::to decide
פני השטח::surface
עמוק::deep
ירח::moon
אי::an island
רגל::foot
מערכת::editorial board
עסוק::busy
מבחן::a test
שיא::record
סירה::boat
משותף::shared
זהב::gold
אפשרי::possible
מטוס::a plane
במקום::instead of
יבש::dry
פלא::wonder
צחוק::laughter
אלף::thousand
רצתי::i ran
לבדוק::to check
משחק::play
צורה::shape
להשוות::compare
מתגעגע::nostalgic
הביא::resulted in
חום::heat
שלג::snow
צמיג::viscous
להביא::bring
כן::yes
למלא::play
מזרח::east
שפה::language
יחידה::unit
העיר::the city
קנס::fine
מסוים::a certain
לעוף::fly
ליפול::fall down
להוביל::to lead
זעקה::cry
אפל::dark
מכונה::referred to
הערה::note
לחכות::wait
תכנית::program
דמות::character
כוכב::star
תיבה::box
שם עצם::noun
שדה::field
שאר::rest
תוכל::will be able to
קילו::kilo
יופי::beauty
כונן::drive
עמד::stood
להכיל::to contain
מול::opposite
ללמד::teach
שבוע::week
סופי::final
נתתי::i gave
ירוק::green
הו::oh
מהיר::fast
לפתח::develop
אוקיינוס::ocean
חופשי::free
דקות::subtlety
חזק::strong
מיוחד::special
דעה::opinion
מאחור::behind
ברור::obviously
זנב::a tail
לייצר::produce
עובדה::fact
חלל::space
שמע::audio
הטוב ביותר::best
שעה::hour
טוב יותר::better
במהלך::during
מאה::century
חמש::five
לזכור::remember
צעד::step
מוקדם::early
להחזיק::to hold
מערב::west
קרקע::ground
עניין::interest
להגיע::to arrive
מהר::faster
פועל::worker
לשיר::sing
להקשיב::listen
שש::six
שולחן::table
נסיעה::drive
פחות::less
בוקר::morning
עשר::ten
פשוט::simple
תנועה::movement
לקראת::towards
מלחמה::war
שכבתי::i lay down
נגד::against
דפוס::printing press
איטי::slow
מרכז::coordinator
אהבה::love
אדם::a person
כסף::of money
לשרת::to serve
להופיע::appear
כביש::road
המפה::the map
גשם::rain
שלטון::government
למשול::govern
למשוך::attract
קר::cold
הודעה::message
קול::voice
אנרגיה::energy
ציד::hunting
סביר::likely
מיטה::a bed
אח::brother
ביצה::egg
תא::cell
מאמין::believes
לבחור::to choose
פתאומי::sudden
לספור::to count
רבוע::square
משך::duration
מייצג::represents
אמנות::art
נושא::topic
גודל::size
להשתנות::vary
להתיישב::settle down
לדבר::speak
משקל::weight
כללי::general
קרח::ice
המעגל::the circle
זוג::pair
כולל::including
פער::gap
הברה::syllable
הרגיש::felt
כדור::ball
בכל זאת::even though
גל::wave
טיפה::drop
לב::heart
בבוקר::in the morning
נוכחי::current
כבד::liver
ריקוד::dance
מנוע::engine
עמדה::position
זרוע::arm
רחב::wide
מפרש::sail
חומר::material
יער::forest
לשבת::to sit down
מירוץ::race
חלון::window
חנות::shop
הקיץ::summer
רכבת::a train
לישון::sleep
להוכיח::prove
בודד::single
תרגיל::exercise
קיר::wall
מלכוד::catch
מאחל לי::wish me
שמים::sky
לוח::board
שמחה::joy
חורף::winter
ישבתי::i sat down
נכתב::written
פראי::wild
מכשיר::player
שמר::kept
זכוכית::glass
דשא::grass
פרה::cow
קצה::end
ביקור::a visit
האחרון::the last one
רך::soft
כיף::fun
בהיר::bright
גז::jazz
מזג אוויר::weather
חודש::a month
מיליון::one million
גימור::finishing
שמח::happy
מקווה::hope
פרח::flower
להלביש::dress
מוזר::mozar
נעלם::disappeared
מסחר::trade
מנגינה::tune
טיול::trip
משרד::office
פה::here
מדויק::precise
סמל::symbol
למות::die
לפחות::at least
צרות::trouble
צעקה::yell
אלא::but rather
כתבתי::i have written
זרע::seed
טון::tone
להצטרף::join
מציע::offers
נקי::net
הפסקה::pause
גברת::mrs
חצר::yard
לעלות::rise
רע::bad
מכה::blow
שמן::oil
דם::blood
לגעת::to touch
גדלתי::i grew up
סנט::senate
לערבב::to stir
צוות::staff
חוט::wire
עלות::cost
איבדתי::i lost
ללבוש::wear
גן::garden
שווה::equal
שלחתי::i sent
נפלתי::i fell down
להתאים::match
לזרום::flow
הוגן::fair
בנק::bank
לאסוף::pick up
להציל::to rescue
שליטה::control
עשרוני::decimal
אוזן::ear
די::enough
פרץ::breach
מקרה::case
אמצע::middle
להרוג::to kill
בן::son
אגם::lake
רגע::moment
בקנה מידה::in a scale
רם::ram
האביב::spring
להתבונן::look
ישר::straight
עיצור::consonant
אומה::nation
מילון::dictionary
חלב::milk
מהירות::speed
שיטה::method
איבר::organ
לשלם::pay
גיל::age
סעיף::section
שמלה::dress
ענן::cloud
הפתעה::a surprise
שקט::quiet
אבן::stone
זעיר::tiny
טיפוס::typhus
מגניב::cool
לעצב::to design
עני::poor
מגרש::court
ניסיון::experience
תחתון::lower
מפתח::key
ברזל::iron
אחת::one
מקל::stick
דירה::apartment
עשרים::twenty
עור::skin
חיוך::smile
קמט::wrinkle
חור::a hole
לקפוץ::to jump
תינוק::baby
שמונה::eight
כפר::village
נפגש::meets
שורש::root
לקנות::buy
להעלות::raise
לפתור::to solve
מתכת::metal
דחיפה::push
שבע::seven
שלישי::third
תהא::will be
מוחזק::is held
שיער::hair
לתאר::describe
טבח::massacre
רצפה::floor
תוצאה::outcome
לשרוף::burn
גבעה::hill
חתול::cat
המאה::century
לשקול::consider
החוק::the law
קצת::some
החוף::the coast
עותק::copy
ביטוי::phrase
חול::sand
אדמה::land
גליל::galilee
טמפרטורה::temperature
אצבע::finger
תעשייה::industry
ערך::value
מאבק::struggle
שקר::a lie
הכה::hit
לרגש::excite
טבעי::natural
תצוגה::display
תחושה::feel
הון::fortune
לא יהיה::will not be
כיסא::chair
סכנה::danger
פירות::fruits
עשיר::rich
עבה::thick
חיל::force
תהליך::process
בפועל::in practice
נפרד::broke off
רופא::doctor
בבקשה::you are welcome
להגן על::protect
הצהריים::noon
יבול::crop
מודרני::modern
אלמנט::element
פגע::affliction
סטודנט::student
פינה::corner
מפלגה::party
אספקה::supply
של מי::whose
אתר::site
טבעת::ring
אופי::character
חרקים::insects
נתפס::caught
התקופה::the period
מצביע על::pointing at
רדיו::radio
דיברתי::i spoke
אטום::atom
היסטוריה::history
השפעה::effect
חשמלי::electric
מצפה::expecting
עצם::closed
להניח::let
לספק::to provide
מסכים::agree
עדין::gentle
אישה::wife
קפטן::captain
מניח::assumes
הכרחי::necessary
חד::sharp
כנף::wing
ליצור::create a
השכן::the neighbor
לשטוף::wash
עטלף::a bat
ולא::and no
קהל::crowd
תירס::corn
מחרוזת::necklace
פעמון::bell
תלויים::hanging
בשר::meat
לשפשף::rub
צינור::pipe
מפורסם::published
דולר::dollar
זרם::current
פחד::fear
מראה::mirror
דק::thin
משולש::triangular
למהר::hurry
ראשי::main
מושבה::colony
שעון::watch
עניבה::tie
להיכנס::to enter
טרי::fresh
חיפוש::search
לשלוח::to send
צהוב::yellow
אקדח::gun
לאפשר::enable
הדפסה::printing
מת::dead
מדבר::speak
חליפה::a suit
מעלית::elevators
עלה::increased
אדון::sir
מסלול::route
הורה::parent
החלוקה::the division
גיליון::sheet
להעדיף::prefer
להתחבר::connect
שלאחר::post
לבלות::spend
אקורד::chord
שומן::fat
מקורי::original
מניה::share
תחנה::station
אבא::father
לחם::bread
לחייב את::to force
ראוי::proper
בר::bar
הצעה::proposal
קטע::segment
עבדים::slaves
ברווז::duck
מיידי::immediate
שוק::street market
תואר::degree
לאכלס::populate
חומוס::hummus
יקר::expensive
אויב::enemy
להגיב::to respond
משקה::beverage
להתרחש::to occur
תמיכה::support
נאום::a speech
טבע::nature
טווח::range
קיטור::steam
נתיב::path
נוזל::liquid
התכוון::meant
מנה::dose
שיניים::teeth
פגז::shell
צוואר::neck
חמצן::oxygen
סוכר::sugar
מוות::death
מיומנות::proficiency
נשים::women
עונה::season
פתרון::solution
מגנט::magnet
תודה::thanks
סניף::branch
סיומת::ending
במיוחד::especially
תאנה::fig
חושש::afraid
ענק::huge
אחות::sister
פלדה::steel
לדון::discuss
קדימה::forward
דומה::similar
להנחות את::guide the
ציון::score
תפוח::an apple
קניתי::i bought
הוביל::has led
המגרש::the pitch
מעיל::a coat
מסה::mass
כרטיס::card
להקה::a band
חבל::too bad
תלוש::detached
לנצח::win
לחלום::dream
ערב::evening
מצב::situation
הזנה::feeding
כלי::tool
סך הכל::total
בסיסי::basic
ריח::smell
עמק::valley
כפול::dual
מושב::session
להמשיך::continue
בלוק::block
תרשים::chart
כובע::hat
למכור::sell
הצלחה::success
חברה::society
להחסיר::subtract
אירוע::event
בפרט::in particular
עסקה::transaction
לשחות::swim
ההפך::the opposite
נעל::shoe
כתף::shoulder
התפשטות::spread
לסדר::arrange
מחנה::campsite
להמציא::invent
כותנה::cotton
נולד::was born
לקבוע::determine
ליטר::liter
תשע::nine
משאית::truck
רעש::noise
רמה::level
סיכוי::chance
מתיחה::prank
לזרוק::to throw away
ברק::lightning
רכוש::property
טור::column
מולקולה::molecule
בחר::select
לא נכון::not true
אפור::gray
חוזר::circular
דורש::requires
להכין::prepare
מלח::salt
האף::the nose
לשון רבים::plural
כעס::anger
טענה::claim
יבשת::mainland