como::like
I::i
seu::your
que::what
ele::he
foi::was
para::for
em::in
são::they are
com::with
eles::they
ser::to be
uma::an
tem::have
este::this one
a partir de::from
por::per
quente::hot
palavra::word
mas::but
o que::which
alguns::some
é::it's
você::you
ou::or
teve::he had
o::o
de::in
a::the
e::and
nós::we
lata::tin
fora::outside
outro::other
foram::were
fazer::do
tempo::time
se::if
vontade::will
disse::he said
cada::each
dizer::tell
faz::he does
conjunto::set
três::three
quer::would you like
ar::air
bem::well
também::also
jogar::play
pequeno::little
fim::the end
colocar::put on
casa::house
ler::read
mão::hand
port::port
grande::great
soletrar::spell
adicionar::add
mesmo::same
terra::earth
aqui::on here
necessário::required
alto::high
tais::such
siga::follow
ato::act
por que::why
perguntar::to ask
homens::men
mudança::change
fui::i went
luz::light
tipo::type
off::off
precisa::need
imagem::image
tentar::try
novamente::again
animais::animals
ponto::score
mãe::mom
mundo::world
perto::close
construir::ramp up
auto::self
pai::dad
qualquer::any
novo::new
trabalho::work
parte::part
tomar::to take
obter::get
lugar::place
feito::done
viver::to live
onde::where
depois::later
de volta::back
pouco::little
apenas::only
rodada::round
homem::men
ano::year
veio::he came
exposição::exposure
bom::good
me::me
dar::to give
nossa::wow
sob::under
nome::name
muito::very
através::through
justo::fair
forma::form
sentença::verdict
acho que::i think
ajudar::help
baixo::low
linha::line
diferir::to differ
vez::turn
causa::cause
significar::to mean
antes::before
direito::right
menino::boy
velho::old
ela::is it over there
tudo::everything
lá::there
quando::when
up::up
usar::to use
maneira::manner
sobre::about
muitos::many
escrever::write
faria::would make
assim::thus
estes::these
longo::far away
coisa::thing
veja::look
dois::two
olhar::to look
mais::most
dia::day
poderia::could
ir::go
vir::come over
fez::did
número::number
som::sound
não::not
pessoas::people
meu::mine
sei::know
água::water
chamada::call
primeiro::first
pode::he can
para baixo::down
lado::side
sido::been
agora::now
encontrar::meet
cabeça::head
ficar::to stay
próprio::own
página::page
deveria::it should
país::parents
encontrado::found
resposta::answer
escola::school
crescer::grow up
estudo::study
ainda::yet
aprender::learn
planta::plant
cobertura::roof
alimentos::foods
sol::sun
quatro::four
entre::in between
estado::state
manter::to maintain
olho::eye
nunca::never
último::last
deixar::to leave
pensava::thought
cidade::city
árvore::tree
atravessar::pass through
fazenda::farm
difícil::difficult
começo::start
poder::power
história::story
serra::mountain range
longe::away
mar::sea
desenhar::to draw
esquerda::left
tarde::evening
run::run
enquanto::while
imprensa::press
noite::night
reais::real
vida::life
poucos::few
norte::north
livro::book
carregam::carry
tomou::took
ciência::science
comer::eat
quarto::bedroom
amigo::friend
começou::started
idéia::idea
peixe::fish
montanha::mountain
Pare::stop
uma vez::one time
base::base
ouvir::hear
cavalo::horse
corte::cut
certo::right
assista::watch
cor::color
rosto::face
madeira::wood
principal::main
aberto::open
parecem::seem
juntos::together
próximo::next
branco::white
crianças::kids
início::start
andar::floor
exemplo::example
facilidade::facility
papel::paper
grupo::group
sempre::ever
música::song
aqueles::those ones
tanto::so much
marca::brand
muitas vezes::often
carta::letter
até::until
milha::mile
rio::river
carro::car
pés::foot
cuidados::care
segunda::monday
suficiente::enough
plain::plain
menina::girl
habitual::habitual
jovem::young
pronto::ready
acima::above
vermelho::red
lista::list
embora::although
sentir::to sense
Discussão::discussion
pássaro::bird
em breve::coming soon
corpo::body
cão::dog
família::family
direto::direct
representar::represent
canção::song
medir::measure
porta::door
produto::product
preto::black
curta::short
numeral::numeral
classe::class
vento::wind
pergunta::question
acontecer::happen
completo::complete
navio::ship
área::area
metade::a half
rocha::rock
ordem::order
fogo::fire
sul::south
problema::problem
peça::ask
sabia::you knew
passar::to spend
desde::since
topo::top
inteiro::i complete
rei::king
rua::road
polegada::inch
multiplicar::multiply
nada::nothing
curso::course
roda::wheel
força::strength
azul::blue
objeto::object
decidir::decide
superfície::surface
profunda::deep
lua::moon
ilha::island
pé::foot
sistema::system
ocupado::busy
teste::test
registro::record
barco::boat
comum::common
ouro::gold
possível::possible
avião::plane
seca::dry
pergunto::i ask
risada::laughter
mil::thousand
atrás::behind
ran::ran
verifique::check
jogo::match
equiparar::match
senhorita::ms
trouxe::he brought
calor::heat
neve::snow
pneu::tire
trazer::to bring
sim::yes
distante::distant
preencher::fill
leste::east
pintar::to paint
linguagem::language
unidade::unity
multa::traffic ticket
voar::to fly
cair::fall
conduzir::drive
grito::shout
escuro::dark
máquina::machine
nota::note
esperar::wait
plano::flat
figura::figure
estrela::star
caixa::box
substantivo::substantive
campo::field
resto::rest
correto::right
capaz::able
libra::lb
done::done
beleza::beauty
contêm::contain
frente::front
ensinar::to teach
semana::week
finais::finals
deu::it gave
verde::green
ó::o
rápida::fast
desenvolver::to develop
oceano::ocean
livre::free
minuto::minute
forte::strong
especial::special
mente::mind
claro::clear
cauda::tail
produzir::to produce
fato::fact
espaço::space
ouvido::heard
melhor::best
horas::hours
verdade::truth
durante::during
cem::one hundred
cinco::five
lembre-se::remember if
passo::step
cedo::early
segurar::hold
oeste::west
solo::ground
juros::fees
alcançar::catch up
rápido::fast
verbo::verb
cantar::sing
ouça::listen
seis::six
mesa::table
viagens::trips
menos::any less
manhã::morning
dez::ten
simples::simple
vários::many
vogal::vowel
direção::direction
guerra::war
lay::lay
contra::against
padrão::pattern
lento::slow
centro::center
amo::master
pessoa::people
dinheiro::money
servir::serve
aparecer::appear
estrada::road
mapa::map
chuva::rain
regra::rule
governar::to rule
puxe::pull
frio::cold
aviso::warning
voz::voice
energia::energy
caça::hunting
provável::likely
cama::bed
irmão::brother
ovo::egg
passeio::tour
celular::cell phone
acreditar::believe
talvez::perhaps
escolher::choose
súbita::sudden
contar::tell
quadrado::square
razão::reason
comprimento::length
arte::art
assunto::subject
região::region
tamanho::size
variar::vary
resolver::solve
falar::to speak
peso::weight
geral::general
gelo::ice
círculo::circle
par::pair
incluir::include
dividir::share
sílaba::syllable
sentido::sense
bola::ball
onda::wave
coração::heart
am::am
presente::gift
pesado::heavy
dança::dance
motor::motor
posição::position
braço::arm
ampla::wide
vela::candle
material de::material of
fração::fraction
floresta::forest
sentar-se::sit down
corrida::race
janela::window
loja::store
verão::summer
trem::train
sono::sleep
provar::to test
solitário::lonely
perna::leg
exercício::exercise
parede::wall
captura::catch
mount::mount
desejo::desire
céu::sky
conselho::advice
alegria::happiness
inverno::winter
sat::sat
escrito::written
selvagem::wild
instrumento::instrument
guardado::saved
vidro::glass
grama::gram
vaca::cow
borda::edge
sinal::signal
visita::visit
passado::past
suave::soft
diversão::fun
brilhante::brillant
gás::gas
mês::month
milhão::million
suportar::support
acabamento::finishing
feliz::happy
Esperamos::we wait
flor::flower
vestir::wear
estranho::strange
gone::gone
comércio::business
melodia::melody
viagem::travel
escritório::desk
receber::receive
boca::mouth
exata::exact
símbolo::symbol
morrer::to die
dificuldade::difficulty
exceto::except
escreveu::he wrote
semente::seed
tom::tone
juntar-se::to get together
sugerir::suggest
limpo::clean
pausa::break
senhora::madam
quintal::yard
subir::move up
ruim::bad
golpe::coup
óleo::oil
sangue::blood
tocar::touch
cresceu::grown up
cento::hundred
misturar::mix
equipe::team
fio::thread
custo::cost
perdido::lost
marrom::brown
desgaste::wear
jardim::garden
igual::equal
enviado::sent
caiu::it fell
caber::fit
fluir::flow
feira::fair
banco::bank
recolher::to recall
salvar::to save
controle::control
decimal::decimal
bastante::quite
quebrado::broke
caso::case
meio::quite
matar::to kill
filho::son
lago::lake
momento::time
escala::scale
primavera::spring
observar::observe
criança::kid
reta::straight
consoante::consonant
nação::nation
dicionário::dictionary
leite::milk
velocidade::velocity
método::method
órgão::organ
pagar::pay
idade::age
seção::section
vestido::dress
nuvem::a cloud
surpresa::surprise
calma::calm
pedra::stone
minúsculo::tiny
subida::climb
legal::cool
projeto::project
pobre::poor
experiência::experience
inferior::bottom
chave::key
ferro::iron
único::single
vara::stick
plana::flat
vinte::twenty
pele::skin
sorriso::smile
vinco::crease
buraco::hole
saltar::jump
bebê::drink
oito::eight
aldeia::village
meet::meet
raiz::source
comprar::purchase
levantar::rise
de metal::of metal
empurre::push
sete::seven
parágrafo::paragraph
terceiro::third
deve::he must
held::held
cabelo::hair
descrever::to describe
cozinheiro::cooker
piso::floor
resultado::result
queimar::burn
hill::hill
seguro::safe
cat::cat
século::century
considerar::consider
bit::bit
costa::coast
cópia::copy
frase::phrase
silenciosa::silent
areia::sand
rolo::roll
temperatura::temperature
dedo::finger
indústria::industry
valor::value
luta::fight
mentira::lie
bater::hit
excitar::excite
naturais::natural
vista::view
Capital::capital
não vai::will not
cadeira::chair
perigo::danger
frutas::fruits
rico::rich
grossa::thick
soldado::soldier
processo::process
operar::operate
prática::practice
separado::separate
médico::doctor
por favor::please
proteger::protect
meio-dia::midday
colheita::harvest
moderno::modern
elemento::element
acertar::to hit
estudante::student
canto::corner
festa::party
fornecimento::supply
cuja::whose
localizar::to locate
anel::ring
caráter::character
inseto::insect
capturados::captured
período::time course
indicam::indicate
rádio::radio
falou::said
átomo::atom
humano::human
efeito::it is made
elétrica::electric
osso::bone
trilho::rail
imaginar::to imagine
fornecer::to supply
concordar::to agree
mulher::woman
capitão::captain
sharp::sharp
asa::wing
criar::to create
vizinho::neighbor
lavagem::wash
bat::bat
multidão::crowd
milho::corn
comparar::to compare
poema::poem
corda::rope
sino::bell
dependem::depend
carne::beef
esfregar::to rub
tubo::pipe
famoso::famous
dólar::dollar
córrego::stream
medo::fear
fina::slim
triângulo::triangle
planeta::planet
apressar::rush
chefe::boss
colônia::cologne
relógio::clock
mina::mine
amarrar::to tie
introduzir::introduce
maior::bigger
fresco::fresh
pesquisa::search
enviar::to send
amarelo::yellow
pistola::gun
permitir::to allow
impressão::print
morto::dead
local::local
deserto::desert
terno::tuxedo
atual::current
elevador::elevator
aumentou::increased
chegar::to arrive
mestre::teacher
trilha::trail
divisão::division
folha::sheet
substância::substance
favorecer::favor
conectar::to connect
pós::post
acorde::wake up
gordura::fat
original::original
share::share
estação::station
pão::bread
cobrar::demand
adequada::proper
bar::pub
oferta::offer
segmento::segment
escravo::slave
pato::duck
instant::instant
mercado::marketplace
grau::degree
pinto::chick
caro::expensive
inimigo::enemy
responder::answer
bebida::drink
ocorrer::to occur
apoio::support
discurso::speech
natureza::nature
gama::gamma
vapor::steam
movimento::movement
caminho::path
líquido::liquid
log::log
significava::meant
quociente::quotient
dentes::teeth
casca::shell
pescoço::neck
oxigênio::oxygen
açúcar::sugar
morte::death
habilidade::abiliity
mulheres::women
temporada::season
solução::solution
ímã::magnet
prata::silver
obrigado::thanks
ramo::branch
sufixo::suffix
especialmente::especially
figo::fig
enorme::huge
irmã::sister
aço::steel
discutir::to discuss
para a frente::foward
similar::similar
orientar::guide
contagem::score
maçã::apple
comprou::bought
conduziu::led
casaco::jacket
massa::pasta
cartão::card
banda::band
deslizamento::slipping
vitória::victory
sonhar::to dream
condição::condition
alimentação::food
ferramenta::tool
total de::total of
básico::basic
cheiro::smell
vale::valley
nem::nor
duplo::double
assento::seat
continuar::continue
bloco::block
gráfico::graphic
chapéu::hat
vender::sell
sucesso::success
companhia::company
subtrair::subtract
evento::event
negócio::business
mergulho::dive
prazo::deadline
oposto::opposite
esposa::wife
sapato::shoe
ombro::shoulder
propagação::propagation
organizar::organize
acampamento::camping
inventar::to invent
algodão::cotton
Nascido::born
determinar::to determine
nove::nine
caminhão::truck
ruído::noise
nível::level
oportunidade::opportunity
trecho::excerpt
brilho::shine
propriedade::property
coluna::column
molécula::molecule
selecione::select
errado::wrong
cinza::gray
repetição::repetition
exigir::demand
amplo::broad
preparar::prepare
sal::salt
nariz::nose
plural::plural
raiva::anger
reivindicação::claim
continente::continent