как::how
Я::i am
его::his
что::what
он::he
было::it was
для::for
на::on
являются::are
с::with
они::they
быть::to be
в::v
один::one
иметь::have
это::this is
от::from
по::on
горячий::hot
слово::word
но::but
некоторые::some
является::is an
вы::you
или::or
площадь::square
из::from
гора::mountain
и::and
основной::basic
взял::took
мы::we
может::maybe
другой::another
были::were
который::which the
сделать::do
их::their
время::time
если::if
будет::will
указанный::specified
назад::back
каждый::each
сказать::to tell
делает::does
набор::kit
три::three
хочу::want
воздух::air
хорошо::ok
также::also
играть::play
небольшой::small
конец::the end
положить::put
домой::home
читать::read
рука::hand
порт::port
большой::big
заклинание::spell
добавлять::add
даже::even
земля::earth
здесь::here
должны::must
высокий::high
такие::such
следовать::to follow
акт::act
почему::why
спросите::ask
люди::people
изменение::the change
пошел::went
свет::light
вид::view
нуждаться::to need
дом::house
картинка::picture
пытаться::try
нам::us
снова::again
животных::animals
точка::point
мать::mother
мир::peace
около::about
строить::build
самостоятельно::on one's own
отец::father
любой::any
новый::new
работа::work
часть::part
принимать::accept
получать::receive
место::a place
сделал::did
жить::live
где::where
после::after
немного::little
только::only
круглый::round
человек::human
год::year
пришел::came
шоу::show
хорошее::good
меня::me
давать::to give
наш::our
под::under
название::title
очень::very
через::across
просто::simply
форма::the form
приговор::sentence
думать::think
помощь::help
низкий::short
линия::line
отличаются::differ
поворот::turn
причиной::cause
много::many
означать::mean
до::before
движение::traffic
право::right
мальчик::boy
старый::old
слишком::too much
же::the same
она::she
все::all
там::there
когда::when
вверх::up
использование::usage
ваш::your
способ::way
о::o
многие::many
затем::then
запись::recording
бы::would
подобно::like
так::so
эти::these
ее::her
долго::for a long time
вещь::thing
посмотреть::look
два::two
имеет::it has
искать::search
еще::yet
день::day
мог::could
идти::go
приходят::come
число::number
звук::sound
нет::no
наиболее::most
мой::my
над::above
знать::know
вода::water
чем::how
вызов::call
первый::first
кто::who
вниз::way down
сторона::side
был::was
сейчас::now
находить::find
руководитель::supervisor
стоять::stand
страница::page
страна::country
найдено::found
ответ::answer
школа::school
расти::grow
исследование::study
учиться::study
завод::plant
крышка::lid
еда::food
солнце::sun
четыре::four
между::between
состояние::condition
держать::keep
глаз::eye
никогда не::never
Последнее::last thing
позволять::let
мысль::thought
город::town
дерево::wood
пересекают::cross
ферма::farm
трудно::hard
начало::start
мощи::relics
история::history
пила::saw
далеко::far
море::sea
привлечь::attract
слева::left
поздно::late
запустить::to run
не::not
в то время как::while
нажмите::click
близко::close
ночь::night
реальный::real
жизнь::life
несколько::several
к северу::to north
книга::book
нести::carry
наука::the science
есть::there is
номер::room
друг::friend
начал::started
идея::idea
рыба::a fish
остановить::stop
раз::once
база::base
слышать::hear
лошадь::horse
вырезать::cut
уверен::sure
смотреть::watch
цвет::colour
лицо::face
открыт::open
кажется::seems
вместе::together
следующий::next
белый::white
дети::children
начать::begin
получил::received
ходить::walk
пример::example
легкость::ease
бумага::paper
группа::group
всегда::always
музыка::music
тех::those
знак::sign
часто::often
письмо::letter
км::km
река::river
автомобиль::automobile
футов::feet
уход::care
Второй::second
достаточно::enough
равнина::plain
девушка::young woman
обычно::usually
молодой::young
готовый::ready
выше::above
когда-либо::ever
красный::red
список::list
хотя::although
чувствовать::feel
разговор::talk
птица::bird
скоро::soon
тело::body
собака::dog
семья::a family
прямой::straight
представляют::present
оставить::leave
песня::song
измерять::to measure
дверь::a door
продукт::product
черный::black
короткая::short
цифра::number
класс::class
ветер::wind
вопрос::question
произойдет::will happen
полная::complete
корабль::ship
половина::half
рок::rock
порядок::order
огонь::fire
юг::south
проблема::problem
кусок::piece
сказал::said
знал::knew
проходить::pass
топ::top
весь::the whole
король::king
улица::street
дюйм::inch
умножить::multiply
ничего::nothing
курс::well
оставаться::stay
колеса::wheels
полный::full
сила::force
синий::blue
объект::an object
решать::decide
поверхность::surface
глубоко::deep
луна::moon
остров::island
фут::foot
система::system
занято::busy
тест::test
лодка::a boat
общая::general
золото::gold
возможно::maybe
самолет::airplane
вместо него::instead of him
сухой::dry
Интересно::interesting
смех::laughter
тыс::ths
побежал::ran
проверять::check
игра::the game
приравнять::equate
мисс::miss
принес::brought
тепло::warmly
снег::snow
шина::tire
приносить::bring
да::yes
удаленная::remote
заполнить::fill in
восток::east
краска::dye
язык::language
среди::among
блок::block
мощность::power
отлично::great
летать::fly
падать::fall
привести::lead
крик::scream
темно::dark
машина::a car
примечание::note
ждать::wait
план::plan
фигура::figure
звезда::star
коробка::box
существительное::noun
поле::field
остальные::rest
верный::loyal
состоянии::condition
фунт::lb.
сделано::made
красота::the beauty
привод::drive unit
стоял::stood
содержать::contain
передние::front
учить::learn
неделя::a week
окончательный::final
дал::gave
зеленый::green
ой::oh
быстро::quickly
развивать::develop
океан::ocean
теплый::warm
бесплатно::is free
минут::minutes
сильный::strong
специальный::special
ум::mind
за::per
ясно::clear
хвост::tail
производить::produce
факт::fact
пространство::space
слышал::heard
лучше::better
час::hour
правда::truth
во::in
сто::hundred
пять::five
запомнить::remember
шаг::step
рано::early
удерживайте::hold
запад::west
интерес::interest
достичь::to attain
глагол::verb
петь::sing
слушать::listen
шесть::six
стол::table
поездки::travel
меньше::smaller
утро::morning
десять::ten
простой::simple
гласный::vowel
к::to
война::war
заложить::lay down
против::against
шаблон::sample
медленно::slowly
центр::centre
любовь::love
деньги::money
служить::serve
появляются::appear
дорога::road
карта::map
дождь::rain
правило::the rule
управлять::to govern
тянуть::to pull
холодный::cold
уведомление::notification
голос::voice
энергия::energy
охота::hunting
вероятный::likely
кровать::bed
брат::brother
яйцо::egg
поездка::the trip
клеток::cells
верить::believe
выбрать::select
внезапный::sudden
считать::think
Квадратный::square
причина::cause
длина::length
представлять::represent
искусство::art
Заголовок::heading
область::region
размер::the size
меняться::change
урегулировать::settle
говорить::talk
вес::the weight
общий::general
лед::ice
дело::a business
круг::circle
пара::pair
включают::include
разделяй::share
слог::syllable
чувствовал::felt
великий::great
мяч::ball
волна::wave
падение::the fall
сердце::heart
утра::in the morning
присутствует::is present
тяжелый::heavy
танец::dance
двигатель::engine
положение::position
широкий::wide
парус::sail
материал::material
доля::share
лес::forest
сидеть::sit
гонка::race
окно::window
магазин::shop
лето::summer
поезд::train
сон::dream
доказывать::prove
одинокий::lonely
нога::leg
упражнение::the exercise
стена::wall
улов::catch
крепление::fastening
хотите::want to
небо::sky
доска::board
радость::joy
зима::winter
Сб::sat
написанный::written
дикий::wild
инструмент::tool
хранится::kept
стекло::glass
трава::grass
корова::cow
край::edge
визит::visit
мимо::by
мягкая::soft
весело::funny
яркий::bright
газа::gas
погода::weather
месяц::month
миллион::million
отделка::finishing
счастливы::happy
надеюсь::hope
цветок::flower
одевать::dress
странный::strange
ушел::gone
торговля::trade
мелодия::melody
офис::office
строка::line
рот::mouth
точный::accurate
символ::symbol
умереть::die
мере::least
беда::trouble
кроме::except
писал::wrote
семян::seed
тон::tone
присоединиться::join
предложить::offer
чистый::clean
перерыв::break
леди::lady
двор::yard
подниматься::get up
плохо::poorly
удар::hit
масло::butter
кровь::blood
коснуться::touch
выросла::increased
цент::cent
смешивать::to mix
команда::command
провод::the wire
Стоимость::price
потерянный::lost
коричневый::brown
носить::wear
сад::garden
равный::equal
отправлено::sent
выбирать::choose
упал::fell
соответствовать::correspond
течь::flow
ярмарка::fair
банк::bank
собирать::collect
сохранить::save
контроль::control
десятичной::decimal
ухо::ear
вполне::quite
сломал::broke
средний::average
убивать::kill
сын::a son
озеро::lake
момент::moment
шкала::scale
громко::loud
весна::spring
наблюдать::observe
ребенок::child
прямо::directly
согласный::consonant
нация::nation
словарь::dictionary
молоко::milk
скорость::speed
метод::method
орган::organ
платить::to pay
возраст::age
раздел::chapter
платье::the dress
облако::cloud
сюрприз::surprise
тихо::quiet
камень::stone
крошечный::tiny
подъем::rise
круто::cool
дизайн::design
бедный::poor
эксперимент::experiment
снизу::from below
ключ::key
железо::iron
палка::stick
плоским::flat
двадцать::twenty
кожа::leather
улыбка::smile
складка::fold
отверстие::hole
прыжок::bounce
восемь::eight
деревня::village
Знакомства::acquaintance
корень::root
купить::buy
поднимать::lift up
решить::decide
металла::metal
ли::whether
толчок::push
семь::seven
пункт::paragraph
третий::third
должен::should
ручные::manual
волосы::hair
описывать::describe
повар::cook
этаж::floor
результат::result
сжечь::burn
холм::hill
сейф::safe
кошка::cat
век::century
рассматривать::to consider
Тип::type of
закон::law
побережье::coast
копия::copy
фраза::phrase
тихий::quiet
песок::sand
почвы::soil
рулон::roll
температура::temperature
палец::finger
промышленность::industry
значение::meaning
борьба::wrestling
ложь::lying
бить::beat
возбуждать::to excite
естественный::natural
смысл::meaning
капитал::capital
не будет::will not
стул::chair
опасность::danger
фрукты::fruits
богатые::rich
толщиной::thick
солдат::soldier
процесс::process
работать::work
практика::practice
отдельный::separate
трудный::difficult
врач::doctor
пожалуйста::please
защищать::protect
полдень::noon
урожай::harvest
современный::modern
элемент::element
хит::hit
студент::student
угол::injection
партия::the consignment
поставка::supply
чьи::whose
разместить::place
кольцо::ring
характер::character
насекомое::insect
пойманный::caught
период::period
указывать::point out
радио::radio
говорил::spoke
атом::atom
эффект::the effect
электрический::electric
ожидать::expect
кость::bone
железнодорожные::railway
вообразить::imagine
обеспечить::to provide
соглашаться::agree
таким образом::thus
нежный::gentle
женщина::female
капитан::captain
догадываться::guess
необходимо::necessary
резкое::sharp
крыло::wing
создавать::create
сосед::neighbor
стирка::washing
летучая мышь::bat
а::a
толпа::crowd
кукуруза::corn
сравнить::compare
стихотворение::poem
колокол::bell
зависеть::depend
мясо::meat
руб::rub
трубка::a tube
известный::known
доллар::dollar
поток::flow
страх::fear
зрение::vision
тонкий::thin
треугольник::triangle
планета::planet
спешить::hurry
главный::main
колония::the colony
часы::watch
шахта::mine
связать::to tie
введите::enter
основным::the main
свежий::fresh
поиск::search
отправить::send
желтый::yellow
пистолет::gun
печать::seal
мертвый::dead
пустыня::desert
костюм::costume
ток::current
лифт::elevator
приходим::we arrive
мастер::master
трек::track
родитель::parent
берег::coast
деление::division
лист::sheet
вещество::substance
пользу::benefit
подключать::connect
пост::fast
провести::conduct
аккорд::chord
жира::fat
довольный::pleased
оригинальный::original
станция::station
папа::dad
хлеб::bread
взимать::charge
собственно::actually
бар::bar
предложение::offer
сегмент::segment
раб::slave
утка::duck
растворимый::soluble
рынок::market
степень::degree
заселять::populate
цыпленок::chick
дорогой::expensive
враг::enemy
напиток::drink
происходить::take place
поддержка::support
речь::speech
природа::nature
диапазон::range
путь::way
жидкости::liquids
войти::to come in
означало::meant
фактор::factor
зубы::teeth
оболочка::shell
шея::neck
кислорода::oxygen
сахар::sugar
смерть::death
довольно::enough
умение::skill
женщины::women
сезон::season
решение::solution
магнит::magnet
серебро::silver
спасибо::thanks
филиал::branch
матч::match
суффикс::suffix
особенно::especially
рис::rice
боится::fears
огромный::huge
сестра::sister
сталь::steel
обсуждать::discuss
вперед::forward
похожи::similar
направлять::guide
опыт::an experience
счет::check
яблоко::apple
купленный::bought
привело::led
пальто::coat
масса::weight
полоса::band
веревка::rope
скольжение::slip
выиграть::win
мечтать::dream
вечер::evening
корма::stern
запах::smell
долина::valley
ни::nor
двойной::double
сиденья::seat
продолжать::continue
диаграмма::diagram
шляпа::hat
продать::sell
успех::success
компания::company
вычитать::subtract
мероприятие::event
частности::particular
сделка::deal
плавать::swim
термин::term
напротив::against
жена::wife
обуви::shoe
плечо::shoulder
распространение::spread
организовать::organize
лагерь::camp
изобретать::invent
хлопок::cotton
родившийся::born
определять::define
кварта::quart
девять::nine
грузовик::truck
шум::noise
уровень::level
шанс::chance
протяжение::stretch
бросать::throw
блеск::shine
имущество::property
колонка::speaker
молекула::molecule
неправильно::not right
серый::gray
повторение::repetition
требовать::demand
подготовить::to prepare
соль::salt
нос::nose
множественное::plural
гнев::anger
претензии::claims
континент::continent