como::what
yo::I
su::its, your, his, their, her
que::that, which, who
él::he
era::was
para::for
en::on
son::are
con::with
ellos::them
ser::be
en::on
uno::one
tener::to have
este::this
desde::from
por::by
caliente::hot
palabra::word
pero::but
qué::what
algunos::some
es::it is
lo::it
usted::you
o::or
tenido::had
la::the
de::from
a::to
y::and
un::a
en::on
nos::us
lata::can
fuera::out of
otros::others
eran::were
que::that
hacer::do
su::its
tiempo::weather
si::yes
lo hará::it will
cómo::excuse me
dicho::saying
un::a
cada::each
decir::tell
hace::does
conjunto::set
tres::three
querer::want
aire::air
así::so
también::too
jugar::play
pequeño::little
fin::end
poner::put
casa::home
leer::read
mano::hand
puerto::port
grande::big
deletrear::spell out
añadir::add
incluso::even
tierra::earth
aquí::here
debe::has to
grande::big
alto::high
tal::such
siga::follow
acto::act
por qué::why
preguntar::to ask
hombres::mens
cambio::change
se fue::he went
luz::light
tipo::kind
fuera::out of
necesitará::will need
casa::home
imagen::image
tratar::treat
nosotros::u.s
de nuevo::again
animal::animal
punto::point
madre::mother
mundo::world
cerca::close
construir::build up
auto::car
tierra::earth
padre::dad
cualquier::any
nuevo::new
trabajo::job
parte::part
tomar::take
conseguir::to get
lugar::place
hecho::done
vivir::to live
donde::where
después::after
espalda::back
poco::little
sólo::single
ronda::round
hombre::man
años::years
vino::came
show::show
cada::each
buena::good
me::i
dar::give
nuestro::our
bajo::low
nombre::name
muy::very
a través de::through
sólo::single
forma::shape
frase::sentence
gran::big
pensar::to think
decir::tell
ayudar::help
bajo::low
línea::line
ser distinto::differ
a su vez::at the same time
causa::cause
mucho::much
significará::will mean
antes::before
movimiento::movement
derecho::right
niño::kid
viejo::old
demasiado::too
misma::same
ella::she
todo::everything
hay::there are
cuando::when
hasta::until
uso::use
su::its
camino::path
acerca::about
muchos::many
entonces::then
ellos::them
escribir::to write
haría::would do
como::what
así::so
éstos::these
su::its
largo::long
hacer::do
cosa::thing
ver::watch
él::he
dos::two
tiene::have
buscar::search for
más::plus
día::day
podía::could
ir::to go
venir::come
hizo::did
número::number
sonar::dream
no::no
más::plus
personas::persons
mi::me
sobre::upon
saber::to know
agua::water
que::that
llamada::call
primero::first
que::that
puede::may
abajo::down
lado::side
estado::state
ahora::now
encontrar::find
cabeza::head
de pie::standing
propio::own
página::page
debería::it should
país::country
encontrado::found
respuesta::answer
escuela::school
crecer::growing up
estudio::study
todavía::yet
aprender::learn
planta::plant
cubierta::cover
alimentos::food
sol::sun
cuatro::four
entre::come in
estado::state
mantener::maintain
ojo::eye
nunca::never
último::latest
dejar::let
pensado::thought-out
ciudad::town
árbol::tree
cruzar::cross
granja::farm
duro::lasted
inicio::beginning
podría::could
historia::history
sierra::saw
ahora::now
mar::sea
dibujar::draw
izquierda::left
tarde::late
ejecutar::run
no::no
mientras::while
prensa::press
Cerrar::to close
noche::evening
reales::real
vida::life
pocos::few
norte::north
libro::book
llevar::carry
tomó::i take
ciencia::science
comer::eat
habitación::bedroom
amigo::friend
comenzó::started
gusta::like
peces::fishes
montaña::mountain
Deténgase::stop
una vez::one time
base de::base of
escuchar::listen
caballo::horse
cortada::cut
seguro::safe
ver::watch
colores::colors
cara::face
madera::wood
principal::principal
abierta::open
parecer::seem
juntos::together
próximo::next
blanco::white
niños::kids
comenzar::start
conseguido::got
caminar::walk
ejemplo::example
aliviar::relieve
papel::paper
grupo::group
siempre::forever
música::music
los::the
ambos::both of them
marca::mark
menudo::often
carta::letter
hasta::until
milla::mile
río::river
coche::car
pies::feet
cuidado::watch out
segundo::second
suficiente::enough
llano::flat
chica::girl
habitual::habitual
joven::young man
listo::ready
por encima de::above
nunca::never
rojo::red
lista::ready
aunque::although
sentir::feel
charla::chat
pájaro::bird
pronto::early
cuerpo::body
perro::dog
familia::family
directa::direct
plantear::pose
dejar::let
canción::song
medir::to size
puerta::door
producto::product
negro::black
corto::short
numeral::numeral
clase::class
viento::wind
pregunta::question
suceder::happen
completo::full
buque::vessel
zona::zone
medio::half
roca::rock
orden::order
fuego::fire
sur::south
problema::trouble
pieza::part
dicho::saying
sabía::i knew
pasar::pass
desde::from
cima::top
todo::everything
rey::king
calle::street
pulgadas::inches
multiplicar::multiply
nada::any
curso::course
quedarse::to stay
rueda::wheel
completo::full
fuerza::strength
azul::blue
objeto::object
decidir::decide
superficie::surface
profunda::deep
luna::moon
isla::island
pie::foot
sistema::system
ocupado::busy
prueba::proof
registro::registration
barco::boat
común::common
oro::gold
posible::possible
plano::flat
lugar::place
seco::dried
maravilla::wonderful
risa::laughter
mil::thousand
hace::does
corrió::ran
comprobar::check
juego::play
forma::shape
equiparar::equate
caliente::hot
señorita::miss
traído::brought
calor::hot
nieve::snow
neumáticos::tires
traer::bring
sí::yes
distante::distant
llenar::fill in
al este::to the east
pintar::paint
idioma::idiom
entre::come in
unidad::unit
potencia::power
ciudad::town
fina::fine
cierto::certain
volar::to fly
caer::fall
conducir::drive
grito::scream
oscuro::dark
máquina::machine
nota::note
espere::wait
plan de::plan of
figura::figure
estrella::star
caja::box
sustantivo::noun
campo::countryside
resto::rest
correcta::correct
capaz::capable
libra::pound
hecho::done
belleza::beauty
unidad::unit
destacado::outstanding
contener::contain
delante::in front of
enseñar::to teach
semana::week
último::latest
dio::it gave
verde::green
oh::oh
rápido::quick
desarrollar::develop
océano::ocean
caliente::hot
libre::free
minuto::minute
fuerte::strong
especial::special
mente::mind
detrás::behind
claro::sure
cola::line
Produce::produces
hecho::done
espacio::space
oído::hearing
mejor::better
horas::hours
mejor::better
verdadero::true
durante::during
cien::one hundred
cinco::five
recordar::remind
paso::he passed
temprana::early
mantenga::keep up
oeste::west
suelo::ground
interés::interest
llegar::to get
rápido::quick
verbo::verb
cantar::to sing
escuchar::listen
seis::six
mesa::desk
viajes::travels
menos::less
mañana::morning
diez::ten
sencilla::simple
varios::several
vocal::vocal
hacia::toward
guerra::war
sentar::sit
contra::against
patrón::pattern
lenta::slow
centro::center
amar::to love
persona::person
dinero::money
servir::to serve
aparecerá::will appear
carretera::road
mapa::map
lluvia::rain
regla::rule
gobernar::govern
Halar::pull
frío::cold
aviso::notice
voz::voice
energía::energy
caza::hunting
probable::probable
cama::bed
hermano::brother
huevo::egg
paseo::walk
celular::mobile
creer::to believe
quizás::maybe
recoger::pick up
repentina::sudden
contar::tell
plaza::square
razón::reason
longitud::length
representar::represent
arte::art
sujeto::subject
región::region
tamaño::size
variar::to vary
resolver::sort out
hablar::talk
peso::weight
general::general
hielo::ice
materia::matter
círculo::circle
par::pair
incluir::include
brecha::gap
sílaba::syllable
sentido::sense
gran::big
bola::ball
aún::still
ola::wave
caer::fall
corazón::heart
am::a.m
presente::present
pesada::heavy
danza::dance
motor::motor
posición::position
brazo::arm
amplio::large
vela::candle
materiales::materials
fracción::fraction
bosque::forest
sentarse::sit down
carrera::career
ventana::window
tienda::shop
verano::summer
tren::train
sueño::sleep
demostrar::show
solitario::lonely
pierna::leg
ejercicio::exercise
pared::wall
capturas::catches
monte::mountain
desear::to wish
cielo::heaven
bordo::board
alegría::joy
invierno::winter
satélite::satelite
escrito::written
salvaje::wild
instrumento::instrument
guardado::saved
vidrio::glass
hierba::herb
vaca::cow
trabajo::job
borde::edge
signo::sign
visita::visit
pasado::last
suave::gentle
diversión::fun
brillante::shiny
gas::gas
tiempo::weather
mes::month
millones::millions
soportar::put up with
acabado::finish
feliz::happy
esperanza::hope
flor::flower
vestir::wear
extraño::strange
se ha ido::it is gone
comercio::commerce
melodía::melody
viaje::trip
oficina::office
recibir::receive
fila::row
boca::mouth
exacta::exact
símbolo::symbol
morir::to die
menos::less
problema::trouble
grito::scream
excepto::except
escribió::wrote
semilla::seed
tono::tone
unirse::join
sugerir::suggest
limpia::clean
rotura::break
dama::lady
patio::playground
aumentando::increasing
mal::wrong
golpe::knock
aceite::oil
sangre::blood
tocar::play
creció::grew up
ciento::hundred
mezclar::mix
equipo::team
alambre::wire
costo::cost
perdido::lost
marrón::brown
desgaste::wear
jardín::yard
igual::equal
enviado::sent
elegir::choose
cayó::it fell
encajar::to fit in
fluir::flow
justo::just
banco::bank
recoger::pick up
guardar::save
el control::the control
decimal::decimal
oído::hearing
demás::the rest
bastante::pretty
rompió::broke
caso::case
medio::half
matar::kill
hijo::child
lago::lake
momento::moment
escala::scale
fuerte::strong
primavera::spring
observar::watch
niño::kid
recta::straight
consonante::consonant
nación::nation
diccionario::dictionary
leche::milk
velocidad::speed
método::method
órgano::organ
pagar::to pay
edad::age
sección::section
vestido::dress
nube::cloud
sorpresa::surprise
tranquila::quiet
piedra::stone
pequeño::little
ascenso::ascent
fresco::cool
diseño::design
pobre::poor
mucho::much
experimento::experiment
inferior::lower
clave::key
hierro::iron
sola::alone
palillo::toothpick
plana::flat
veinte::twenty
piel::skin
sonrisa::smile
pliegue::fold
agujero::hole
saltar::jump
bebé::baby
ocho::eight
pueblo::village
se reúnen::they meet
raíz::root
comprar::to buy
aumentar::increase
resolver::sort out
de metal::of metal
si::yes
empujar::push
siete::seven
párrafo::paragraph
tercero::third
deberá::shall
en espera::on hold
pelo::hair
describir::describe
cocinero::chef
piso::flat
ya sea::either
resultado::outcome
quemar::burn down
colina::hill
seguro::safe
gato::cat
siglo::century
considerar::to consider
tipo::kind
ley::law
bit::bit
costa::coast
copia::copy
frase::sentence
silencio::be quiet
de altura::tall
arena::sand
suelo::ground
rollo::roll
temperatura::temperature
dedo::finger
industria::industry
valor::value
lucha::struggle
mentira::lie
batir::shake
excitar::excite
naturales::natural
vista::view
sentido::sense
de capital::capital
no lo hará::it will not
silla::chair
peligro::danger
fruta::fruit
rica::delicious
de espesor::of thickness
soldado::soldier
proceso::process
operar::operate
práctica::practice
separada::separated
difícil::hard
médico::doctor
por favor::please
proteger::to protect
mediodía::noon
de cultivos::of crops
moderno::modern
elemento::element
golpear::beat
estudiante::student
esquina::corner
partido::match
suministro::supply
cuya::whose
localizar::to locate
anillo::ring
carácter::character
insecto::insect
capturado::captured
período::period
indicar::indicate
Radio::radio
habló::speak
átomo::atom
humana::human
historia::history
efecto::effect
eléctrica::electric
esperar::expect
hueso::bone
ferrocarril::railway
imaginar::imagine
proporcionar::provide
acuerdo::agreement
por tanto::therefore
suave::gentle
mujer::woman
capitán::captain
adivinar::guess
necesario::necessary
agudo::acute
ala::to
crear::create
vecino::neighbour
lavado::washed
bate::bat
más bien::rather
multitud::crowd
maíz::corn
comparar::compare
poema::poem
cadena::chain
campana::campaign
dependerá::will depend
carne::meat
frotar::rub
tubo::tube
famoso::famous
dólar::dollar
corriente::current
miedo::afraid
vista::view
delgado::slim
triángulo::triangle
planeta::planet
prisa::rush
jefe::boss
colonia::suburb
reloj::watch
mina::mine
empate::tie
entrar::get in
importante::important
fresco::cool
búsqueda::search
enviar::send
amarillo::yellow
pistola::gun
permitir::let
print::print
muerto::dead
lugar::place
desierto::desert
traje::costume
actual::current
ascensor::lift
rosa::pink
llegar::to get
master::master
pista::track
padre::dad
orilla::bank
división::division
hoja::leaf
sustancia::substance
favorecer::favor
conectar::connect
mensaje::message
pasar::pass
acorde::chord
grasa::fat
contento::happy
originales::original
cuota::share
estación::station
papá::dad
pan::bread
cobrar::collect
adecuada::adequate
barra::bar
oferta::offer
segmento::segment
esclavo::slave
pato::duck
instantánea::snapshot
mercado::market
grado::degree
poblar::populate
polluelo::chick
querido::dear
enemigo::enemy
responder::answer
bebida::drink
producirse::occur
apoyo::support
discurso::speech
naturaleza::nature
alcance::scope
vapor::steam
movimiento::movement
camino::path
líquido::liquid
log::log
significado::meaning
cociente::quotient
dientes::teeth
concha::shell
cuello::neck
oxígeno::oxygen
azúcar::sugar
muerte::death
bastante::pretty
habilidad::ability
mujeres::women
temporada::season
solución::solution
imán::magnet
plata::silver
gracias::thank you
rama::branch
partido::match
sufijo::suffix
especialmente::especially
higo::fig
miedo::afraid
enorme::enormous
hermana::sister
acero::steel
discutir::argue
adelante::ahead
similar::similary
guiar::guide
experiencia::experience
puntuación::punctuation
manzana::apple
comprado::bought
llevado::carried
pitch::pitch
abrigo::coat
masa::mass
tarjeta::card
banda::band
cuerda::rope
deslizamiento::glide
ganar::to win
soñar::sound
noche::evening
condición::condition
pienso::i think
herramienta::tool
totales::totals
básico::basic
olor::smell
valle::valley
ni::neither
doble::double
asiento::seat
continuar::continue
bloque::block
tabla::table
sombrero::hat
vender::sell
éxito::success
empresa::company
restar::subtract
evento::event
particular::particular
acuerdo::agreement
nadar::to swim
plazo::term
opuesta::opposite
esposa::wife
zapato::shoe
hombro::shoulder
propagación::spread
organizar::organize
campamento::camp
inventar::invent
algodón::cotton
nacido::born
determinar::decide
cuarto de galón::quart
nueve::nine
camión::truck
ruido::noise
nivel::level
oportunidad::chance
reunir::gather
tienda::shop
tramo::stretch
lanzar::throw
brillo::brightness
propiedad::property
columna::column
molécula::molecule
seleccionar::to select
mal::wrong
gris::gray
repita::repeat
exigir::demand
amplio::large
preparar::set up
sal::salt
nariz::nose
plurales::plural
cólera::anger
reclamación::claim
continente::continent
